
# ###############################################################################
#. . .#. .#. . . .#.#. . . .#. . .#. .#. . . .#. .#. . . . . .#.#. . . . . . . .#
##### # ### # ### # # ### ### ### # # # ### # # # # ##### ### # # ##### ### #####
#. .#.#. . .#.#. .#.#. .#. . . .#.#.#.#. .#.#.#.#.#. .#.#. .#. .#.#. .#. .#.#. .#
# ### ### ### ### # ### ######### # # ### # # # ##### # ### # ### # # ### ### # #
#. .#. .#. .#. .#. .#.#. . .#.#. .#.#. .#.#.#.#. . .#. . .#.#.#. .#.#. . .#. .#.#
### ### # ##### ### # ##### # # ### ### # # # # # ####### # # # ### # ##### ### #
#. . .#.#.#. . .#.#. .#. .#.#.#. . .#.#. .#.#.#.#. . .#. .#.#.#.#. .#.#. . . .#.#
# ### # ### ##### ### # # # # ####### ##### # ##### ### ### ### # ##### ####### #
#.#. .#.#. .#. . .#. . .#.#. .#. . . .#. . .#. . .#. . .#.#. . .#.#. . .#.#. .#.#
# ##### # ##### # # ######### # ### ### ######### # ##### ####### # ##### # # # #
#. . .#.#. . .#.#. .#.#. . . .#. .#. .#. . . .#.#.#. . . .#. . . .#. . .#.#.#. .#
# ### # ### # ##### # # ############# ####### # # ####### # ##### ##### # # ### #
#.#. .#. .#.#.#. .#. .#.#. . . .#. .#. .#. .#.#.#. . .#. .#. .#. . . .#.#.#.#. .#
### ##### # # # # ### # # # ### # # # # # # # # ##### ####### ######### # # #####
#. .#. .#.#.#. .#.#.#.#.#.#.#. . .#.#.#. .#.#.#. . .#. . . .#. . .#. .#. .#.#. .#
# ### # # ##### # # # # ### ####### # ####### # # ######### ##### # # ### # # # #
#.#. .#. .#. .#.#.#. .#. .#. .#. . . .#. . .#.#.#. .#. . .#. . .#. .#. . .#. .#.#
# # ####### # ### ####### ### ######### ### # # ### # # # ##### # ############# #
#.#. .#. . .#. .#. . . . . . .#. . .#. .#.#.#.#. .#.#.#.#. . .#.#.#. . . .#. . .#
# ### ##### ### # ########### # ### # ### # # ### # # # ####### # ##### # # ### #
#. .#. .#. .#. .#.#. . . .#. .#.#.#.#. .#.#. .#. .#.#.#. .#. . .#. . . .#.#.#. .#
# # ### # ### ### # ##### ##### # # ### # ##### ### # ### # ############# # ### #
#.#. .#.#. .#.#. .#. .#. .#. . .#.#. . .#. . .#.#. .#.#.#. .#.#. . .#. .#.#. .#.#
# # ### ### # ####### # ### ##### ####### ### ### ### # ##### # ### # # # ### # #
#.#. .#. .#.#.#. . . .#.#. . . .#. . .#. .#.#. .#. .#. .#.#. .#.#.#. .#. .#. .#.#
##### ### # # # ####### ####### ### # ### # ### ### ### # # # # # ######### ### #
#. . . .#.#.#. .#. . .#. . .#. .#. .#. . .#. . .#. .#. .#. .#. .#.#. . . .#.#. .#
# ##### # # ####### # ##### # ### ######### ##### # # ##### ##### # ##### # #####
#. . .#.#.#. .#. . .#.#. .#. .#. .#. . . .#.#. . .#.#.#. .#. . . .#.#. .#.#.#. .#
# ### ### ### # ##### # ####### ### ####### # ##### # # # ######### # ### # # # #
#.#.#. .#. .#.#.#.#. .#. . . . .#.#. . . .#.#. .#. .#. .#. .#. .#. .#. . .#. .#.#
# # ### ### # # # # ##### ####### # ##### # # # ########### # # # ### ######### #
#. .#. .#.#. .#.#.#.#. .#.#. . . .#.#. .#. .#.#. .#. . . .#. .#. .#. .#. . . .#.#
# ### # # ##### # # # # # # ####### ### ######### # # ### ######### ### ##### # #
#.#. .#. . . . .#.#. .#. .#. .#. . .#. .#. . . .#. .#.#. .#. .#. . .#. . .#. .#.#
### ############# ########### # ##### # ### ### ##### ##### # # ######### # ### #
#. .#. . . . . . . . .#. . . .#. . . .#. .#.#.#. . .#. .#. .#.#.#.#. . . .#. . .#
# ####### # ### ####### # ####### ####### # # ##### # # # ### # # # # ######### #
#.#. . .#.#. .#.#. . .#.#. . . . .#. . .#. .#. . . .#.#.#.#.#.#.#. .#.#. . . .#.#
# # ### # ### # # ### # ########### ### ##### ######### # # # # ##### # ##### ###
#. .#. .#. .#.#.#.#.#. .#. . . . . . .#. .#. .#. . . .#.#. .#. .#. . .#. . .#. .#
# ### ##### # ### # ##### ############### ### ### ### # ### ##### ####### ##### #
#.#.#. . .#.#. .#. .#. . .#. . . . .#. .#. .#. . .#. . . .#.#. . .#. . . .#. .#.#
# # ##### # ### ### # ##### ######### # ### ############### ##### # ####### # # #
#. .#. . .#. .#. . .#.#. . .#. . . .#.#. . .#. . . . . . . .#. . .#.#. . .#.#.#.#
### # ### ####### ### # ##### ##### # ####### ############### ##### # # # # # # #
#. .#.#. .#. . .#. .#.#.#. . .#. . .#.#. .#. .#. . . .#.#. .#. . . .#.#.#.#.#. .#
##### # ### ### ##### # # ##### ### # # # # ### # ### # # # # ####### # # # ### #
#. . .#. .#.#. .#. . .#. .#. . .#. .#. .#. .#. .#.#.#.#. .#. .#. . .#.#.#.#. .#.#
# ####### # # ### ######### # ################### # # # ######### # ### ##### # #
#. .#.#. .#.#. . .#. . . . .#.#. . . . . . . . . .#. .#.#. . . . .#. .#. . .#.#.#
### # # ### ########### ##### # ####### ########### ### # # ######### ##### # ###
#. .#. . .#.#. . . . .#.#. . .#. .#. .#. .#. .#. .#.#.#.#.#. . .#. .#. . .#.#. .#
# ##### ### # ####### # # ####### # ##### # # # # # # # ####### # # ##### # ### #
#. . .#.#. .#. . . .#. .#.#. . .#.#. . .#.#.#.#.#.#.#. .#. . .#. .#.#. . . . .#.#
# ### ### ### ##### ##### ### ### # # # # # # ### # # ### ### ##### ########### #
#. .#.#. .#. .#. .#.#. .#. .#.#. .#.#.#.#. .#. .#. .#. . .#.#. . . .#. . . . .#.#
### # # ### ##### # # # ### # # ##### # ####### # ######### ####### # ####### # #
#. .#. .#.#.#. . .#. .#.#. . .#. . . .#.#. .#. .#. .#. . .#. .#. . .#.#. . .#. .#
# ####### # # ######### ############### # # # ##### # ### # ### ##### ##### ### #
#. .#. . . .#. . . . .#. .#. . . . . .#. .#.#. .#. . .#. .#. .#.#. .#. .#. . .#.#
### # ####### ####### ### # ### ##### ### ##### ######### # # # # # ### # ##### #
#. .#. . . .#.#. . . .#.#. . .#. .#. .#. .#. .#. . . . .#.#.#. . .#. .#.#. . .#.#
# ######### ### ##### # ##### ### ##### ### # ### ##### # # ######### # ##### # #
#. .#. . .#. .#.#. . . .#. .#. .#. . . . .#.#. .#.#. .#.#.#.#. . . .#.#. . .#.#.#
### # # ##### # ######### # ############# # ### ### # # # ### ##### # ##### # # #
#. .#.#. . . . .#. . . .#.#. . . . . . .#.#. .#. . .#. .#. .#. .#.#.#. . .#.#. .#
# ############### ##### # ############# ### # ############# ### # # ##### # # ###
#.#. . . . . . .#. .#. .#.#. . . . . .#. .#.#. .#. . . . .#.#. .#.#. . .#.#.#. .#
# ### ######### # # # ### # # ####### ### # ### ##### ### # # ### ##### # # #####
#. . .#. . . .#.#.#.#.#. .#.#. . . .#. .#.#. .#. . .#.#.#.#.#.#. . .#. .#.#. . .#
####### ##### # ### # # ### ####### ### # ### ##### # # # # # ##### # ######### #
#. . .#.#.#. .#. .#.#. .#.#. . . .#. .#.#. .#. .#. .#. .#.#.#. . .#.#.#. . . .#.#
# # ### # # ##### # ##### ### ####### # ### ##### ##### # # # ### # # # # ### # #
#.#.#. .#.#. . . .#. . .#. . .#. . . .#.#. .#. . .#. .#.#. .#. .#.#.#.#.#.#. .#.#
# ### ### ######### ### # ##### ######### ### ##### ### ##### ### # # # # # ### #
#.#. .#. . . . .#. . .#.#.#. .#. . . . .#. .#.#. . .#. .#. . .#. .#. .#.#.#.#. .#
# # ##### ##### ####### # # # ######### ### # # ### # ######### ### ##### # ### #
#. . . . .#. . . . . . .#. .#. . . . .#. . . .#. .#. . . . . . .#. . . . .#. . . 
#################################################################################