
# ###################
#. .#. .#.#. . . . .#
### # # # # # ##### #
#.#. .#.#. .#. . .#.#
# ##### # ####### ###
#. .#. .#.#. . .#. .#
# # # ### # ### ### #
#.#. .#.#.#. .#. .#.#
# ##### # ### # # # #
#.#.#. . .#. .#.#.#.#
# # # ######### # # #
#.#. . . .#. . .#.#.#
# ####### # ### ### #
#. . . .#. .#. .#. .#
####### ##### ### ###
#. . .#.#. .#. .#. .#
# ### # # # ##### # #
#.#. .#. .#. . .#.#.#
# # ########### ### #
#.#. . . . . . . . . 
#####################