
# ###############################################################################
#. . .#. . . . . . . .#. . . . . .#. . .#. . . .#. .#. . . . . . .#. . .#. . . .#
##### ############### # ### ##### ### # ##### # ### # ### ####### # # # # ##### #
#.#. .#. . . . .#. .#. .#.#. . .#. . .#. .#. .#. .#. . .#. . .#. .#.#.#.#. . .#.#
# # ### ####### # # ### # ##### ######### # ##### ##### ##### ##### # # # ##### #
#. .#. .#. .#. .#.#. .#. . . .#.#. . . .#. .#. .#. . .#.#. .#. . .#.#.#.#.#. . .#
# ### ### # # ### ### ### ##### # ### ######### ##### # ### ##### # # ### # #####
#. . .#. .#.#.#. .#.#.#. .#. . .#.#. .#. . . . .#. . .#. . . . .#.#.#. .#.#. . .#
######### ### # ### # ##### ####### # # # ####### ############# # # ### # ##### #
#. . . .#. .#.#. .#.#. . . .#. . . .#.#.#. . .#. .#. .#. . . .#.#. . .#. . . .#.#
# ### # # # # ### # ########### ####### ##### # ### # # ##### # ######### ##### #
#. .#.#.#.#.#. . .#.#. . .#. . .#. . . .#. .#. .#. .#.#.#. . .#.#. . . .#.#. . .#
# ### # ### ####### # # ### # ### ######### ##### # # # ### ##### ##### # # ### #
#.#. .#. . .#. .#. .#.#. .#.#. . .#. . .#. .#. .#.#.#.#. .#.#. . .#. .#.#.#.#. .#
# # ####### # # ### # ### # ####### ### # ### # # # # # # # # ##### # # # # # ###
#.#.#. .#. . .#. . .#.#.#. .#. . . .#. . .#. .#. .#.#.#.#.#. .#.#. .#.#.#.#.#. .#
### # # ######### ### # ##### ##### ##### # ####### # # # ##### # ### # ### ### #
#. .#.#. . . . .#.#. .#. .#. . . .#. .#. .#. . . .#.#.#.#.#. . .#.#. .#.#. .#. .#
# # # ######### ### ### ### ##### ### ######### ### # # # ### ### # ### # ### ###
#.#.#. . . .#. .#. .#. . . .#. .#.#. .#. . . . .#. .#.#.#. .#. .#.#. .#. .#.#. .#
# ######### # # # ########### # ### ### ######### ### ##### # # # ### ##### ### #
#.#. . . . .#.#.#.#. . . . . .#. . .#. .#. . . .#. .#.#. . .#.#. .#. .#. . .#.#.#
# # ######### ### # ##### ##### ##### ####### # ### # # ##### ##### # ### # # # #
#. .#. . .#. .#. .#.#. . .#. .#.#. . . . . . .#. .#.#. .#. .#.#. .#.#.#. .#. .#.#
# ### ##### ### ### # ##### # ### ################# ####### # # # # # # ####### #
#.#. .#. . .#. .#. .#. . .#.#. .#. . .#. . . . .#. .#. . . .#.#.#. .#.#. .#. . .#
# # # # ##### ##### ####### ### # ##### ####### # ### ####### # ##### ### # #####
#.#.#.#. . .#. . .#. . .#. . .#. .#. . .#.#. . .#.#. . . . . .#. .#. . . .#.#. .#
# ### ##### ##### ##### # ####### # ##### # ##### # ############# ######### # ###
#. .#. . .#. . .#. . .#. .#. . .#.#.#. . .#.#. . .#. . . . .#. .#.#. . . . .#. .#
### # # # ### # ##### ##### ### ### # ### # ##### ######### # # # # ########### #
#.#.#.#.#. .#.#.#. .#.#. .#.#. . . .#. .#.#. . .#. . . .#.#. .#.#. .#. . . .#. .#
# # # # ### # ### # # # # # # ########### ##### # ##### # ##### ####### ### # # #
#.#.#.#.#.#.#. . .#.#. .#.#.#.#. . . .#. .#. .#.#.#. .#.#. . .#.#. . . .#. . .#.#
# # ### # # ####### ##### # ### ##### # # # # # # # # # ##### # ### ########### #
#.#.#. .#.#.#.#. . . .#.#.#. . . .#. .#.#. .#.#.#. .#.#. . .#. . .#. . . .#. . .#
# # # ### # # # ##### # # ####### # ### ### ### ######### # ##### # ##### # #####
#.#.#.#. .#.#.#.#. .#. .#. . . .#.#. .#.#. .#. . . . . .#.#. .#. .#. . .#.#.#. .#
# # # # ### # # # # # ######### # ### # ##### ######### ##### # ######### # # # #
#.#. .#. . . .#.#.#. .#. . .#. .#. .#.#. . . .#. .#. .#. . . .#. .#. .#. .#. .#.#
# ##### ####### # ##### # ### ####### ######### # ### ########### # # # ####### #
#. .#. .#. . . .#.#. . .#.#. .#. . .#. .#. . . .#. .#. . . .#. .#. .#. .#. .#. .#
# ### ### ####### # ##### # ### ### ### # ######### ### ### # ########### # # ###
#.#. .#.#. . .#. .#. . .#.#. .#. .#. . .#. . . . .#.#. .#.#. .#. . . . .#.#. .#.#
# # ### ##### ### # ##### ### ### ### ##### ####### # ### # ### ##### ### ##### #
#.#. . .#. .#. .#.#.#. . .#. .#. .#. .#. . .#. . . .#.#. . .#. .#. .#. . .#. .#.#
# ##### # # ### # # # ##### ### ####### ##### ####### ####### ### # ####### # # #
#. . .#.#.#.#. .#.#.#. . . .#.#. . . .#. .#. .#. .#. . . . . .#. .#. .#. . .#. .#
# # # # # # # ##### ######### # ##### ### # ### ### ############# ### ### # ### #
#.#.#.#.#.#.#.#. .#.#. .#. . . .#. . . .#.#. .#. . .#. . . .#. . .#. . .#.#.#. .#
# # ### ### # # # # # ### ####### ### ### ### # ####### ### # # ####### ### # ###
#.#. .#.#. .#.#.#. .#. .#.#. . . .#. .#. .#. .#. . .#. .#.#.#.#. . . .#. . .#.#.#
# ### # # ### # ####### # # ########### ### ####### # ### # # ####### ####### # #
#. .#. . .#. .#. .#. .#. .#. . . . . . .#. .#. . .#. .#. . .#. . . .#.#. .#.#. .#
# ######### # ### # # ########### ####### ### # ####### ##### ##### # # # # ### #
#.#. .#. . .#. .#. .#.#. . . . .#.#. . .#. .#.#. . . .#.#. . .#. .#.#. .#.#. .#.#
# # # # ############# # ####### ### ### ### # ### ##### # ##### # ####### # ### #
#.#.#.#.#. . . . . .#. .#. . .#. . .#.#. . .#. .#.#. .#.#.#. . .#.#. . . .#. . .#
### # # # ####### ######### # ####### ######### # # # # # # ##### # ####### #####
#. .#.#.#. .#. .#. . . . .#.#. . . . . .#. . . .#.#.#.#.#.#.#. .#.#.#. . . .#. .#
# ### # ### ### ####### # ######### ### ######### # # # ### # # # # ######### # #
#.#. . . .#. .#. . . .#.#. .#. . .#.#.#.#. . . . .#.#. .#. .#.#.#.#. . . . . .#.#
# ##### ##### ##### ### ### # ### # # # # ### ##### ##### ### # # ##### ####### #
#. .#. .#. . .#. .#.#. .#. .#.#.#. .#.#.#.#.#.#. . .#. . .#. .#.#. . .#. . .#. .#
# # # ### ##### # # # ### ### # ##### # # # # # ##### ##### # ####### ####### # #
#.#.#. .#.#. .#.#. .#. .#. . .#. . . .#.#.#. .#. .#. .#. . .#.#. . .#. .#. . .#.#
# # ##### # # # ### ### ####### ### ### # ### ### # ### # ##### ### ### # ##### #
#.#. .#. .#.#.#. .#. .#. . .#. .#. .#. .#. .#.#.#.#. .#.#.#. .#. .#. .#.#.#. .#.#
# ### # ### # ### ### ##### ### ##### ##### # # # ### ### # # ### # ### # # # # #
#. .#. .#. .#. .#. .#. . .#.#. .#. . .#. . .#. .#. .#. .#. .#. .#.#. . .#. .#.#.#
### ##### ##### # # ####### # ### ####### ######### # # # ##### # ####### ### ###
#. .#. . .#. . .#.#.#. . .#.#. .#.#. . . .#. . . .#.#.#.#.#. .#.#.#. . . . .#. .#
# ### ##### ####### # ### # ### # ##### ### ##### # ### # # ### # # ########### #
#.#. .#. .#.#. . .#.#.#.#.#. .#. . .#. .#. .#. .#. .#. .#. .#. .#.#. .#. .#. .#.#
# # # ### # # # # # # # # ### ##### # # # ##### ##### ##### # ### ### # # # # # #
#.#.#.#. .#.#.#.#.#. . .#. .#. . .#. .#.#. . .#. .#. . . .#.#.#. .#. .#.#.#.#. .#
# # # # # # ### # ####### # ##### ### ####### # # # ##### ### # ####### # # ### #
#.#.#.#.#.#. . .#. . .#. .#.#. .#. .#.#. . .#.#.#. . .#. .#. .#.#. . . .#. .#. .#
# ### # ############# # ### # # ### ### # ### ######### ### ### # ########### ###
#. . .#. . . . . . . . .#. . .#. .#. . .#. . . . . . . .#. . . . .#. . . . . . . 
#################################################################################