
# #############
#.#. . . .#. .#
# # ##### ### #
#. .#. .#. .#.#
##### ##### # #
#. . .#. .#.#.#
# # ### # # # #
#.#.#. .#.#.#.#
# # # ### # # #
#.#.#.#.#. .#.#
# # # # ##### #
#.#.#.#. . . .#
# ### # ##### #
#. . . .#. . . 
###############