
# ###############################################################################
#.#.#. . . . . . . . . .#. . . .#. . . . . . . . .#. .#. . . . . .#. . . . .#. .#
# # # ############### # ####### # ### ######### ### # # ##### ### ##### # # # # #
#.#.#.#. .#. . . . .#.#.#. .#. .#.#. .#. . .#.#.#. .#. .#. .#.#. . . .#.#.#. .#.#
# # # ### # ####### # # # # # # # # ### ### # # # ####### ### ####### ### ##### #
#.#.#.#. .#.#. . . . .#. .#.#.#.#.#. .#. .#.#. .#. .#. . .#. .#. . .#. .#. . .#.#
# # # # ### ############### # # # ### ### # ### ### ### # # ### ### ### ##### # #
#.#. .#. .#. . . . . .#. . . .#.#.#.#. .#.#. .#. .#. . .#.#.#. .#. .#. .#. .#.#.#
# # ### # ########### ########### # ### # ### ########### # # ### ### ### # # ###
#.#. .#.#.#. . . . .#. . . . . . . .#. .#.#.#. . . . . . .#.#.#.#. .#. . .#.#. .#
# ### ### # ####### ################# ### # ############### # # ### ####### ### #
#.#.#. . .#.#. . . . . . .#. . .#. . .#. .#. . .#. . .#. .#. .#. .#. . .#.#.#. .#
# # ##### # ##### ####### # ### # ##### ### # # # ### # # ### # ####### # # # ###
#.#. . .#.#.#. .#.#. .#. .#.#.#.#.#. .#. .#.#.#. .#. .#.#. .#.#. .#. . .#. .#. .#
# # ### # # # # ### # # ### # # # # # ### ### ### ##### ### # ### # ####### ### #
#.#.#. .#.#. .#. .#.#.#. . .#. . .#.#. .#. .#. .#.#. . .#.#.#. . .#.#. . .#. .#.#
# # # ### ####### # # # ########### # # ### ### # # ##### # # ##### # ### ### # #
#.#.#. . .#. . .#. .#.#.#. .#. . . .#.#.#.#. . .#.#. . .#. .#.#. . .#. .#. .#. .#
# ######### ### ### # ### # # ####### # # ####### ##### # ##### ##### ##### #####
#. .#. . .#.#.#. .#.#. . .#. .#. . .#.#. . .#. .#.#. .#.#. . .#. .#. .#. .#. . .#
### # ### # # ### # ####### ####### # ####### # # # # # ##### ### # ### # ##### #
#.#.#.#. . .#. .#.#.#. . .#. . . . .#. . . .#.#. .#.#.#. .#. . .#.#.#.#.#. . . .#
# # # ####### # # # # ### ######### ####### # ####### ### ##### # # # # ####### #
#.#.#. .#. .#.#. .#.#. .#. . .#.#. .#. . .#.#.#. . .#. .#. .#. .#.#. .#. . .#. .#
# # ### # ### ##### ### ##### # # ### ### # # ### # ### ### ### # ### ##### # ###
#.#. . .#. .#.#. .#.#.#. .#. .#. . .#. .#.#. .#. .#. . . .#. .#.#. . . .#. .#. .#
# ######### # ### # # ### # ####### ### # ##### ### ######### # ######### #######
#. . .#. . .#. .#. . . .#.#. .#. .#. . .#. . . .#.#.#. . . . .#. . . .#. .#. . .#
##### # # ##### ######### ### # # ############### # # ############### # ### ### #
#. . .#.#. . .#.#. . . .#.#.#.#.#. . .#. . . .#. . .#.#.#. . . .#. .#.#. .#.#. .#
# ##### ### # # # ##### # # # # ##### # ##### ####### # # ### ### # # # # # # ###
#. . . .#.#.#.#. .#. .#. .#.#.#.#. .#. .#. .#. .#. .#.#.#.#.#. .#.#. .#.#. .#. .#
# ####### # ####### # ##### # # # ####### ##### # # # # # # ### # ########### # #
#.#. . .#.#. . . .#.#. . . .#. .#. . . .#. . .#. .#.#.#. .#. .#. .#. . . . .#.#.#
# ### # # ####### # ####### ####### ##### ### ##### # # ### # ####### ##### ### #
#. . .#. .#. . .#. .#.#. .#. . . . .#. . . .#. . .#. .#. .#.#. . . .#. . .#. .#.#
######### # # ####### # # # ### ##### ######### # ####### ##### ### # ### ### # #
#. . . .#.#.#.#. . . .#.#. .#. .#. . .#. . .#. .#.#. . .#. . .#.#.#.#.#. .#. .#.#
# ### ### # # # ##### # ######### ##### ### # ### # ### ##### # # # ### ### ### #
#. .#.#. .#.#.#.#. .#.#. . . . . . .#. .#.#.#.#. .#.#.#. .#. .#.#.#. . .#.#. . .#
# # # # ##### # ### # ############### ### # # ##### # ### # ### # ####### ##### #
#.#.#.#.#. . .#. . .#. . . .#. .#. . .#. . .#.#. . .#.#. .#.#. .#. . . . .#. . .#
# # # # # ######### # ##### # # # ######### # # ##### # ### # ### ##### ### #####
#.#.#.#.#. .#. . . .#. .#.#. .#.#. . .#. .#. .#. . . .#.#. .#. .#. . .#. . .#. .#
### ### # # # ######### # ##### ##### # # ######### ### # ##### ##### ######### #
#. .#. .#.#. . .#. . . .#.#. . .#. . .#.#.#. .#. . .#. .#. . . .#. .#.#. . . . .#
# # # ### ####### ####### # ##### ##### # # # # ##### ########### ### # ####### #
#.#.#. .#.#. . .#.#. . . .#.#.#. .#. .#.#. .#. .#. .#. .#. . . . .#. .#. . .#. .#
# ##### # # ### # # # ##### # # # # # # ######### ##### # ####### # ####### # ###
#. . .#.#.#.#.#. .#.#. . . . .#.#.#.#.#.#. . .#. . .#. .#. . .#.#. .#. .#. .#. .#
# ### # ### # ##### ########### # # # # # ##### ### # # ##### # ##### # # ##### #
#.#. .#. .#.#. . .#.#. . .#. .#.#.#.#. .#.#. . . .#.#.#.#. .#.#.#. . .#. .#. .#.#
### # ### # # # ### # ##### # # ### ##### # ####### # # # # # # # ### ##### ### #
#. .#. .#. .#.#.#. .#.#. . .#.#. .#. . .#.#.#. .#. .#.#.#.#. .#.#.#. .#. . .#. .#
# ############# # ### # ##### # # ##### # # # # # ### ### ##### # # ### ### # ###
#.#. . . . . .#.#.#. .#. .#. .#.#. . .#.#. . .#.#. .#. . .#. .#. .#. .#.#. .#. .#
# # ### ##### # # ### ### # ####### # # ####### ### ####### # ##### # # ####### #
#.#. .#. .#.#.#.#. .#. .#.#. .#. .#.#.#. . . .#. .#. . . . .#.#. .#.#.#. . . .#.#
# ### ### # # # ### # ### ### # # ### ####### ### ### ####### # # # # ####### # #
#. .#.#. .#. . .#. .#.#. .#. . .#. . .#. . . .#. . .#. . . .#. .#.#.#. . . .#. .#
# ### # ######### ### # ### ######### # ########### ####### ##### # ####### #####
#. .#.#. . . .#. . . .#. .#.#. . . .#.#.#. . . . .#. .#. . .#. .#.#.#.#. .#. . .#
### # ####### # ####### # ### ##### # # # ####### ### # ##### ### # # # # ##### #
#. .#.#. . .#. . .#. .#.#.#. .#. .#.#.#. .#. .#. .#.#.#.#. .#. . .#.#. .#. .#. .#
# # # ### # ####### # # # # ##### # ####### ### ### # # # # ### ### ### ### # ###
#.#.#. . .#.#. . . .#.#.#.#. .#. .#. . . . .#. .#. . .#. .#. .#. .#. .#.#. .#. .#
# ######### # ####### ### ### # ####### # ### ### ######### # ### ### ### # ### #
#.#. .#. . .#. . .#. . . .#. .#.#. .#. .#.#. .#.#.#. . . .#.#. .#.#.#.#. .#. .#.#
# # # # ######### # ####### ### # # # ##### ### # # ##### ##### # # # # ##### # #
#. .#.#. .#.#. . .#. .#. . .#. . .#.#. . . .#. . .#.#. .#. . .#.#.#. .#.#. . .#.#
# ### ### # # ####### # ########### ########### ### # # ##### # # ### # # ##### #
#. .#. .#.#.#. . .#. .#.#. .#. . .#. .#. . . .#.#. .#.#.#. .#. .#. .#. .#. . .#.#
### # ### # ##### ### # # # # ### # # # # ### ### ### ### # ####### ######### # #
#. .#. . .#. . .#. .#.#. .#.#.#. . .#.#.#.#. . .#. .#. . .#. . .#.#. . . .#.#.#.#
# ######### ### ### ####### # ####### # # ##### # # ####### ### # ####### # # # #
#.#. . .#. . .#. .#. . . . .#. . .#. .#.#. . .#.#.#. . .#. .#. . . .#.#. .#. .#.#
# # # # ######### ############# # # ######### # # ##### # ######### # # ##### # #
#.#.#.#. .#. . .#. .#. . . . .#.#.#.#. . . .#.#.#. . .#.#. . . .#. . .#. . .#.#.#
# ### ### # ### # # ####### # ### # # ##### # # ####### # ##### ########### ### #
#. . .#. . .#. . .#. . . . .#. . .#. .#. . . .#. . . . .#. . .#. . . . . . . . . 
#################################################################################