
# #####
#. .#.#
# # # #
#.#. .#
# #####
#. .#. 
#######