
# #############
#. . .#. . . .#
# # ### # ### #
#.#. .#.#.#. .#
##### # #######
#. . . . . .#.#
##### # ### # #
#. .#.#. .#. .#
# # ### ### ###
#.#. . .#. . .#
# ######### ###
#. .#. . .#.#.#
### # ##### # #
#. . . . .#. . 
###############