
# ###########
#.#. . . . .#
# ######### #
#. . .#. .#.#
### ### # # #
#. .#.#.#.#.#
# ##### # # #
#.#. . .#.#.#
# ##### # # #
#. . . . .#.#
##### ### # #
#. . .#. . . 
#############