
# #####
#. .#.#
### # #
#.#. .#
# ### #
#. . . 
#######