
# #####
#. . .#
# ### #
#.#. .#
# ### #
#. .#. 
#######