
# #######
#. . . .#
# ### ###
#. .#. .#
### #####
#. . . .#
# ##### #
#. .#. . 
#########