
# #####
#. . .#
# # # #
#.#.#.#
# ### #
#. .#. 
#######