
# ###################
#. . . .#. .#.#. . .#
# # ### # # # # ### #
#.#. .#.#.#. .#.#.#.#
# # # ####### ### # #
#.#.#. .#.#.#.#.#. .#
##### ### # # # ### #
#. .#. .#.#. . .#. .#
# # # ### ##### ### #
#.#. .#. . . .#. . .#
# ### # ##### ### ###
#.#. . . .#. . . .#.#
##### # ### # ##### #
#.#.#.#.#. .#. . . .#
# # ############# # #
#.#. .#.#.#. . . .#.#
# # ### # ### ##### #
#. .#.#. . . . . .#.#
# ### # ### ####### #
#. . . .#. . . .#. . 
#####################