
#o###################
#. . .#. . . .#. . .#
# ### # ##### # #####
#.#. .#. .#. . .#. .#
##### # ### ### # ###
#. . .#.#.#. .#. . .#
# ##### # ### ### # #
#. . . . . .#.#. .#.#
# ### # # ### ### ###
#.#. .#.#.#.#.#. .#.#
# ### # ### ##### # #
#.#. .#. . . .#. .#.#
# ##### # ######### #
#.#.#. .#.#.#.#. .#.#
### ##### # # ### # #
#.#.#.#.#.#.#. .#. .#
# # # # # # # ### ###
#.#.#.#. .#.#.#.#.#.#
# # # ### # # # # # #
#. . . . . . . . . .o
#####################