
#o###############################################################################
#.#. . . . .#. . . . .#. . . .#. .#. . . .#. . . .#. . . . .#. . . . . . . . . .#
# # ####### ####### ### # ### # # # ##### ##### # # ####### ############# # ### #
#. .#.#. .#. . . .#. . .#.#.#. .#.#. .#. . . . .#. .#. . .#.#. . . . . .#.#.#. .#
##### # # ####### # ##### # ##### ### ############### # ### # ######### ### # ###
#. . .#.#. . .#. .#. .#.#.#. . .#. .#. .#. . . . . .#.#.#. .#. . . .#. . .#.#. .#
# ##### ### # # ##### # # # # ##### # # # # ####### # # # ####### # ##### # #####
#. . . . .#.#.#.#. .#. .#.#.#. . .#.#.#.#.#. .#. .#.#.#.#. . . .#.#. .#.#.#. . .#
##### ##### ### # # ### # ####### # ### # ### # # # # # ####### # ### # # ##### #
#. .#.#. .#.#. .#.#. .#.#.#. . . .#. .#.#. .#. .#.#.#.#. .#. .#.#.#. .#. .#. . .#
# # ### # # # ### ### ### # ##### ### # ### ##### ### ### # # # ### ### ### ### #
#.#. .#.#. .#. .#.#. . .#.#.#. . . .#.#.#. .#. .#. .#.#. .#.#.#. . .#.#.#. .#.#.#
# ### # ### ### # ##### # # ####### # # # ### # ### # # # # # ####### # ### # # #
#. .#. .#.#. .#.#. .#. .#.#. .#. .#.#. .#. . .#. .#.#.#.#.#.#. .#. . .#. . .#.#.#
### ##### ### # # # ### # # # # # ############# ### # # # # ### # # ######### # #
#. .#. . . . .#.#.#. .#. .#.#. .#. . . .#. .#. .#. .#.#.#.#.#.#. .#. . . . .#.#.#
# ### ######### # ### ##### ######### # # # # ### ### # # # # ########### # # # #
#. .#.#. . . .#.#. .#.#. .#. .#. . .#.#. .#.#.#.#. . .#.#.#.#. . .#. . .#.#. .#.#
### # # ##### # # ### # # ### ##### # ####### # ####### # # # # ### # # # ##### #
#. .#.#. . .#.#.#.#. .#.#. .#. .#. .#. . .#. . . .#. . .#.#.#.#. . .#.#.#.#. . .#
# # ####### # # ### ####### ### # # ##### # ##### # ##### # # ####### # # # #####
#.#.#. .#. .#.#. .#.#. . .#. .#. .#. . .#. .#. .#.#.#. . .#.#.#. .#. .#.#. .#. .#
# ### # # ### ### # # ### ### ######### ##### # # # # ##### ### # # ######### # #
#. . .#.#. .#. .#.#.#.#.#.#. .#. .#. . . .#. .#.#.#.#.#.#. .#. .#.#. . . . . .#.#
# ##### # ##### # # # # # # ### # # ##### # ### ### # # # ### ### ##### ####### #
#.#. .#. .#. . .#.#. . .#.#.#. .#. .#. .#.#.#. .#. .#. .#. . .#.#. . . .#. .#. .#
# # # ##### ### # # ##### # # ####### # ### ### # ############# ########### # ###
#. .#. . .#.#. .#.#. .#. .#.#.#. . .#.#. .#. .#. .#. . . .#. .#. . . . . . .#.#.#
##### ##### ##### ##### ### # ### # # ### ### ##### ### ### # # # ##### ##### # #
#. . .#. .#. .#. .#. . .#. .#. .#.#.#. .#. .#.#. . .#.#. .#.#. .#.#. . .#. . .#.#
# ##### # ### # ### ##### ##### # # ### ### # # ##### ### # ##### ### ### ##### #
#. . .#.#. . .#. . .#. . .#. .#.#.#. .#. .#.#.#. . . .#. .#.#. .#. .#. .#. . . .#
##### # ### ######### ### # # # ### # ### # # ##### ### # # # # ### ########### #
#. . .#.#. .#. . . .#. .#.#.#. . . .#.#. .#. .#. . .#. .#.#. .#. .#. . . .#. .#.#
# ##### # ### # ### ### ### ########### ####### ##### ########### ##### # # # # #
#. . .#.#.#. .#.#. . .#. . .#. . . . . .#. .#. .#. .#.#. . . . .#.#. .#.#. .#.#.#
##### # ### ### ##### ##### # # ######### # # ##### # # ####### # ### # ####### #
#. .#.#.#. .#.#. .#. .#. .#.#.#.#. . . . .#. .#. . .#. .#. .#. .#.#. .#. . . .#.#
# ### # # ### ### # ### # ### # # ############# ######### # # ### # # ####### # #
#.#. .#. .#. . .#.#. . .#.#. .#.#.#. . . . .#.#. . .#. . .#.#. . .#.#. .#. . .#.#
# # ####### ### # ####### # ### # # ####### # # ### # # ### ####### ##### ### # #
#.#.#. . . .#. .#. .#. .#. .#. .#. .#. . .#.#. .#.#. .#. .#.#. . . . . .#.#. .#.#
# # ##### ### # ### # # ##### ####### ### # ### # ####### # # ######### # ##### #
#.#.#. .#. .#.#.#. .#.#. . . . .#. . .#. .#. .#. . . . .#.#.#.#. . . .#.#. . .#.#
# # # # # ### # # ##### ######### ### ### ### ########### ### # ##### # ##### # #
#.#. .#.#.#. .#.#. . .#. .#. .#. .#.#. .#. .#. . . . . .#. . .#. .#. .#. . .#. .#
# ##### ### ### ##### ### # # # ### ### ############### # ####### # ####### #####
#. .#. .#. .#.#. . .#.#. .#.#.#. .#. .#. . . . . . .#. .#. .#. . .#. . .#. . .#.#
### # ### ### ##### # # ##### ### # ######### ####### ##### # # ####### # ### # #
#. .#.#. .#. .#. . .#.#. . . .#. .#.#. . . .#.#. . . .#.#. .#.#.#. . .#.#. .#.#.#
# # # # ### # # ##### ####### # ### # # ### # # ####### # ### # # ### ### # # # #
#.#.#. .#. .#.#.#. .#. . . .#.#.#. . .#.#.#.#. .#. . .#. .#. .#.#. .#. .#.#.#. .#
# ####### ##### # # ####### # # ####### # # ####### # # ##### # ### ### ### ### #
#. . . .#. .#. . .#.#. . . .#.#. . . .#.#.#.#. . . .#.#.#. .#.#.#. .#.#. . .#. .#
# ##### # # # ####### ##### ######### # # # ### ##### # # # # # # ### ####### ###
#. . .#. .#. . .#. . .#. .#.#. . . .#.#.#.#.#. .#. .#.#.#.#. .#.#.#. . . . .#.#.#
# ##### ######### ##### ### # # ##### # # # # ### ### # # ##### # # ####### # # #
#.#. .#. . .#. .#. .#.#. . .#.#. . .#. .#.#.#. .#. .#.#.#. .#. .#.#. . .#. .#. .#
### # ####### # ### # # ##### ##### ##### # ### # # # # ### # ### # ### # ##### #
#. .#. . . . .#.#. .#. .#.#. . . .#. . . .#. .#.#.#. .#. . .#. .#.#. .#.#. . .#.#
# ############# # ### ### # ######### ####### # ##### ### ####### ### # ### ### #
#. .#. .#. .#. .#.#.#.#. .#.#.#. . .#. . . .#.#.#. .#. .#.#. . .#.#.#.#.#. .#. .#
### ### # # # ### # # # ### # # ### # ### ### # # # ### # # ### # # # # ##### ###
#. .#. .#.#.#. .#.#.#.#.#. .#.#. .#.#. .#. .#.#. .#.#.#.#.#.#. .#.#. .#. . . .#.#
# ### ### # ### # # # # # ### ### # ####### # # ### # # ### # ### # ########### #
#.#. .#. .#. .#. .#. . .#. .#. .#.#. .#. .#.#.#. .#.#. . . .#.#. .#.#. . . .#. .#
# ### # ### ##### ##### ### ### # ### # # # # ### # ######### # ### # ##### # # #
#. .#. . .#. . . .#. .#. .#.#. .#. .#. .#. .#. .#.#. .#. . .#.#.#. .#. .#. . .#.#
# # ############# # # ### # # ##### ####### ### ##### # # ### # # ### # #########
#.#. .#. . .#. .#.#.#.#. .#.#.#. . .#.#. . . .#. . . .#.#.#. .#.#.#.#.#.#. . . .#
# ### # ### # # ### # ##### # # ##### # ############### ### ### # # # # # ##### #
#. .#.#. .#.#.#. .#.#. . . .#.#. . .#. . . .#. . . . .#. . .#. .#.#. .#. .#. .#.#
### # # ### # ### # ######### ##### ######### ####### # ##### ### ### ##### # # #
#. .#. .#. .#. .#. .#. . . .#. .#. .#. . . . .#.#. . .#.#. .#. .#. .#.#. .#.#. .#
# ####### # ### ##### ### ### # # ### ######### # ### # ### # # ### # # # # ### #
#.#.#. . .#. .#.#. .#. .#. . .#.#. .#.#. . . . .#. .#.#. .#. .#.#.#.#. .#.#.#.#.#
# # # ######### # # ##### ##### ### # # ####### ### # ### ##### # # ####### # # #
#.#.#.#. .#. .#.#.#. . .#. . .#. .#.#.#. . .#. .#.#.#. .#. . . .#.#. . . . .#.#.#
# # # # # # # # # ##### ####### # # # ##### # ### # ############# ########### # #
#. .#. .#. .#. . .#. . . . . . .#.#. . . . .#. . .#. . . . . . . . . . . . . . .o
#################################################################################