
#o###########################################################################################################################################
#. . . .#. . . .#. .#.#.#.#. . . . . . . .#.#.#. . .#. .#.#. . . .#. .#. . .#. . . .#. .#.#. .#. .#.#. . .#. .#. .#. .#.#. . .#.#. . . .#.#.#
# ########### # ### # # # # ### ##### # # # # ### ### # # # ### # ### # ##### ### ### ### # # ### # ### ### ### ### ### # ##### ####### # # #
#. . .#.#.#. .#. . . . .#. .#. . . .#.#.#.#. .#. .#. .#. .#. .#.#.#. . . .#. . .#.#. . . .#.#.#. .#. . . . .#.#. . . . . . . . . .#. . . . .#
# ### # # ### ##### ##### ####### ##### ### # # ####### # ####### ##### ######### ### # ##### # # ### ### ### ####### ### ### ####### # # ###
#.#.#. . . .#. . .#.#. .#. .#. . . .#. . .#.#. .#. . .#.#.#. . . . . .#.#. . .#. . . .#. .#.#. .#. . . .#.#.#.#.#. . .#.#. .#.#. .#.#.#.#.#.#
# # # ### ######### # ##### # ####### ####### ### ####### # # # ####### ### ##### # # # ### ### # # ####### # # # ##### # # ##### # ### ### #
#. .#.#. . . . .#.#. .#.#. .#.#. .#. .#. . . . . . . . . .#.#.#. . . .#. .#.#.#. .#.#.#. .#.#.#.#.#. . . .#. . . . . .#.#.#.#.#. . . . .#. .#
# ####### ### # # ### # ### ### ### ##### ### # ##### # # # ########### ### # # ### # ##### # # ############### ### # # # ### # # # # # # ###
#. .#. . .#. .#. .#.#. .#.#. . .#. . . . . .#.#.#. . .#.#. . .#. .#. .#. . . . .#.#.#.#. . .#. .#.#. .#.#.#. . .#. .#.#. .#. . .#.#.#.#. . .#
##### ### ####### # ### # # ### ##### ### # ### ####### ### ### ### ##### ##### # ####### ##### # # ### # ##### ##### # # ### # ######### ###
#. .#. .#.#. . . .#.#.#. . . .#. . .#.#. .#. .#.#. .#. . .#. . . . . .#.#. .#. . . .#.#. .#. . .#. . .#.#. . .#.#.#. .#.#. . .#.#. .#. . . .#
### # ##### ### # # # ### ##### ### ##### # ####### # ### ### ##### ### ####### ##### ### ### ##### # # ##### ### # ### # ### ### # ### #####
#.#. .#.#. . .#.#. . . .#. . .#.#.#.#.#. .#.#.#.#.#. .#.#.#.#.#. . .#.#. . . . .#.#. . .#.#. . . . .#.#. .#. .#. .#. .#.#.#.#.#. .#.#. . . .#
# ##### ### ##### # ####### # ### ### ##### # # # # # # # # # ##### # ##### ##### # # # # ### ### ####### ### # ### ### ### ### ### ### # ###
#. . .#.#.#. . .#.#.#. . . .#. .#. . . .#.#.#. . . .#.#. .#. .#. . . . . .#. . . . .#.#.#. . .#.#.#. .#. .#. . . . . .#.#. . . .#.#. .#.#. .#
##### # # ######### ##### ### ##### ### # ####### ######### ############# ### ### # # # ### ### ##### # ##### ##### # ##### ### # # #########
#.#.#. . . .#.#. .#.#.#.#.#. .#. . .#.#. .#. . . . . . .#. . . .#.#. . . . .#.#.#.#.#.#. .#. . . . .#. . .#. . .#.#.#.#.#. .#. . .#.#. . . .#
# # # ##### # # # # # # ##### ### ### ######### ### ##### ### # # ########### # ########### ### ### # ########### # # # # # ############# # #
#. . .#. .#. . .#. .#. . .#. .#. . . .#. .#.#. . .#. .#.#. .#.#. . .#. . .#. . . .#. .#. .#.#. . .#.#. .#. . . . .#.#.#. .#. . .#.#. . .#.#.#
# ### # ####### ### # ### ######### # # ### ##### ### # ### ### ##### ##### # ##### # # ### ######### ### # # ##### # ##### # ### ### ### ###
#.#.#.#. . . .#.#.#. . .#. .#. . . .#. . .#. . . . .#. .#. .#. .#. . .#. .#.#.#. . .#. . .#.#.#. .#. . .#.#.#. .#. .#.#. .#.#. . .#. . . . .#
# # ### ### ##### ####### ### ##### ######### ### ##### ####### # ####### ### ######### ### # # ### ##### ##### # # # # ### # ######### # ###
#. .#.#.#. .#. .#.#. . .#.#. .#.#. . .#.#. .#. .#. .#. . . .#. .#. . .#. . . . . .#. . . . . . .#.#.#. .#. .#.#. .#.#. . .#.#. .#. .#. .#. .#
# ### ##### ### # ### ##### ### # ##### ### # ### ### ### ##### # ####### ### # ### ### ### ### # # # ### ### ### # ### ####### ### # ### ###
#. . . .#.#. .#. . .#. . .#. .#.#.#.#. .#. . .#.#. .#. .#.#.#. . .#.#. .#. .#.#.#. .#. . .#. .#.#. . . .#. . .#.#.#.#. .#. . . .#. . .#.#. .#
##### # # # ####### ##### ##### # # # ### ##### # # ##### # ### ### # ### # ### # # ### ### ### # # ##### ##### # # # ### ### ### # # # ### #
#. .#.#. .#. . . .#. .#. .#.#. . . . . . .#. .#. .#. .#. . . .#. .#.#. .#.#. .#. .#.#.#. .#. .#. .#. .#. . .#.#.#.#.#. .#. .#. . .#.#.#. .#.#
# ##### # ### ### ### # # # ### ######### # # ##### # # # # ##### # ### # ####### ### # ####### ### ### ##### # ### # # # ### # ##### ### # #
#. . . .#. . .#. . .#. .#. . .#.#. . . . .#.#. . . .#.#.#.#.#. .#. .#. . .#. .#.#. .#. .#.#. . .#.#. .#. . .#. .#. .#.#. .#. .#.#.#. . .#. .#
# # ### ### # # ### # ### ### ####### ### ### # # # # # ##### ##### # ####### # ### ##### ##### # # # ### # # # # ### ####### ### ### ##### #
#.#.#. .#. .#.#. .#. . .#.#. .#. .#. . .#. .#.#.#.#.#.#. .#. .#. .#. . . . .#. . .#.#. . . . .#.#. .#. . .#.#.#.#.#. . .#. . . . .#. .#.#. .#
### # ##### ##### # # # ######### # # ######### ### ##### ### ### # # ##### ### # # ##### ##### # ### # ##### ##### # # ########### # # ### #
#. .#. .#. .#.#. .#.#.#. . . . . .#.#. .#. . .#. .#. . .#. .#.#. . .#. . .#.#. .#.#. . . . .#. .#.#. .#. . . . .#. .#.#.#. . .#.#. .#.#. . .#
##### ### # # # ### ### ####### ####### ##### # ####### ##### ### ### ######### ### ### ##### ##### ####### ####### # ### ### # ##### ### ###
#. .#. .#.#. .#. .#. .#.#. . .#. .#. . . .#. .#.#. .#. .#. . . . .#.#. . . . . . .#.#. .#. .#. .#. .#. . . . .#.#. .#.#. .#.#. . . . .#.#. .#
### ######### ##### ##### ####### # ### ##### # # # ### ####### # # ### ########### # # ### ##### ### # # # # # # # ####### # ##### # # ### #
#. .#.#. . . . .#. . .#. . . .#.#.#.#. . . . .#.#.#. . . . .#.#.#.#. . . . . .#. . .#.#. . . .#. .#.#.#.#.#.#.#.#.#.#.#.#. . . .#. .#.#. . .#
# ### # # ### # ### ### # # ### ##### # ### # ####### # # ### # ####### ####### # ### ########### # ##### ##### ##### # ##### ##### ##### ###
#. .#. .#. .#.#. .#. .#.#.#.#. . .#. .#.#.#.#. .#. .#.#.#. . .#. . . .#. . .#. .#.#.#. .#.#. . .#.#. .#. .#. . .#. .#. . .#.#. . .#. .#. .#.#
# ##### ##### ### ####### ##### ####### # ### ### ####### # # ### # ### ##### ##### # # # ##### # # # # # ##### ### # ##### ####### # ##### #
#. . .#. .#. . .#.#.#. . .#. . . .#.#. .#. . .#. . .#.#. .#.#.#. .#. .#. .#.#.#. . . .#. .#. . . . .#.#.#. . . .#.#. . .#.#. .#.#. .#.#. . .#
##### ### ######### # ########### # # ### # ### # ### ######### ### ### ### ### ### ### # ##### # ########### ### ### ### # ### # # ##### ###
#.#.#.#. . .#. . .#.#. .#.#. . . .#. . .#.#. .#.#. . .#.#. .#. .#. .#. . .#. . . .#. .#.#.#.#.#.#.#.#.#.#. . . . . . . . . . . .#.#.#. .#. .#
# # # # # # # # ### # ### ####### # ### ### ####### ### # # # ########### ### # ### # ##### # ##### # # # ##### ### ##### ##### ### # # # ###
#. .#. .#.#. .#.#. .#.#. . .#.#. . .#.#.#. .#.#.#. .#. . .#.#.#.#. .#.#.#.#. .#.#. .#. .#. .#.#.#. . .#. .#. .#.#. . .#. . . .#.#.#.#.#. . .#
# ############# # # # # ##### ##### # # ##### # ### ##### ##### # ### # ### ##### ### ### ### # ##### # # ### ##### ### ##### ### ##### ### #
#. . .#.#.#. . .#.#. . . .#.#. .#. . .#.#. . . . . . .#. . .#. . . . .#.#. .#. . . .#. . .#.#. . .#.#.#.#. .#. . .#. .#.#.#. . . . . .#.#.#.#
# # # # # ### ####### ##### # # ##### # # ####### ######### ##### ### # ### ####### ### ### ### ### # # # ### ##### ### # ####### # ### # ###
#.#.#. .#. .#. . .#. . . .#. .#. .#. .#. . . .#. . . .#. . .#.#. . .#. . .#.#. .#. .#. .#. . .#. .#.#. .#. . . .#.#.#.#.#. .#. .#.#. . . . .#
####### ### # ### # # # ##### ### ### ### # ##### ##### ##### # ##### ######### ##### ####### ### # ######### ### # # ##### # ### # # ### ###
#.#.#.#. .#. .#. . .#.#. .#.#. .#.#. .#. .#.#.#. .#.#. .#.#. . . .#. .#. .#. .#. .#. . . .#. . . . .#.#.#.#. .#.#.#.#. .#.#. .#.#.#.#.#. . .#
# # # # ####### # # ### # # # ########### ### ### # ### # ### # # ### # # # ### ##### ### ######### # # # ##### # ### ### ### # ####### # ###
#. .#.#. . .#. .#.#.#.#.#.#.#.#. .#. .#. . .#. . . . .#. .#. .#.#.#. . .#. . . .#. .#.#. . . . . . .#. .#. . . .#. .#. . . .#.#.#. .#. .#.#.#
### # # ##### ##### # # ### # # ### # # ####### # # ### # ####### ####### ####### ### # ### ### # ### # # ####### # ### ### # # ### ### # # #
#. . . .#.#. .#. .#. .#.#.#. . .#. .#. .#. . . .#.#.#.#.#.#. .#.#.#.#. .#. . .#. . .#.#. .#.#. .#. .#.#. . . .#.#.#. . .#.#. . .#. .#. .#. .#
# # ##### ####### # ### # ### ############# # ### ### # ### ### ### ### # # ### ### ##### ##### ### # # ####### ### ##### ### ### # ### #####
#.#. .#.#. .#.#.#. .#. . . .#.#. . .#. . .#.#.#. . . .#. . .#.#.#.#. . . .#.#. .#. .#. .#.#.#. .#.#. .#.#. .#. .#.#.#.#. .#. . . .#. . . . .#
##### # # ### # # # ### ### # # ##### ######### ##### # ### # # # ##### ##### # ####### ### # ### # # ##### # ### ### ### # ### ##### # #####
#. . .#.#.#. . . .#.#.#.#. . . . . . . . .#. .#. . .#. .#. .#. . . .#.#.#. . .#. . . .#.#. . .#. . .#. .#.#.#.#.#.#.#. . . . .#. . .#.#. . .#
##### # # ### ####### ### ##### # # ####### # # ### ##### ### ##### # # # ##### ##### # ######### ##### # # # # # # ####### ### ### ### # ###
#. . . . . . . .#. . . .#.#. . .#.#. . .#. .#. .#.#.#. .#.#. .#.#. .#. . .#. .#.#.#. . . .#.#.#. . .#.#.#. . . . . .#.#. . .#. .#.#.#. .#. .#
# ### ### # ### # # ############### ##### # ### # # # ### ### # ####### ##### ### # ### # # # ##### # ##### ######### ### ####### ### #######
#. .#. .#.#.#.#. .#. . .#.#.#. . . . . . .#.#.#.#. . . .#.#. . .#.#.#. . .#. . . . . .#.#.#. . . .#. .#.#. .#. . . . . .#. . . . .#.#.#.#. .#
# ####### ### ### ##### # # ############### # ### # # # ### ##### # ### ####### # ########### ### # # # # ####### ### ######### # # # # ### #
#. . .#.#.#. . .#. .#. . . .#. . . . . .#. . . .#.#.#.#. . .#. .#. . . . .#. . .#. .#. .#. .#.#. . .#.#.#. .#. . . .#.#. .#.#. .#.#.#. . . .#
### ### ##### # ### ####### ### # ### ### ######### ### ##### ####### ### ### ### ##### # # ####### ### ### ### # ####### # # # ### # # ### #
#.#. .#. .#. .#.#.#. . .#. .#.#.#.#. . .#. .#. . . . .#.#. . . .#. . .#.#.#. .#. . .#. .#.#.#. . . .#. . . . . .#.#. .#.#. . .#. . .#.#.#. .#
# ##### ### ##### # # ####### ######### # ########### ### ### # # ### # # # # ### ##### # ####### # ##### # ### ##### # ##### ### ####### # #
#. . .#. .#. .#. .#.#.#.#. . . .#. . . . . .#.#. . . . .#.#. .#. .#. . .#.#.#.#. . .#. . . . . .#.#. .#. .#. .#.#.#. . . .#. . .#. .#.#. .#.#
# # # # ### ##### ##### ### # # ### ##### # # ### # # ######### ##### ##### ##### ####### ##### # ####### # ### # # ### ### ######### ### ###
#.#.#.#. .#. . . .#. .#. .#.#.#. . . .#. .#. .#. .#.#.#.#. .#. . .#.#.#.#.#.#. .#. .#. . .#. .#.#. . . .#.#. .#. . . .#.#. . . .#. . .#. . .#
### ### ##### ### # ##### ### ##### # ##### # ##### ### # ##### # # # # # ##### # ### ##### ### # ####### ### # # ########### ##### ####### #
#. . . . .#. .#.#.#.#.#.#.#. .#.#. .#.#.#. .#.#. .#. .#.#. .#.#.#.#.#. . . .#. . .#. . . .#.#.#.#.#. .#.#.#. .#.#. . . . . . .#. .#. . . . .#
### # ### ### # ### # # # ##### ####### ######### # ### ### # ### # ##### ### # # ##### ### # ### # ### ### ####### # # ####### # ### ### # #
#.#.#. .#. . . .#. . .#.#.#. .#. .#.#. . .#. . .#. . .#. .#. . . . . .#. .#.#.#.#. . . .#. .#.#.#.#. .#. . . . .#. .#.#. . . . .#. .#.#. .#.#
# ######### ######### # # # ### ### ##### # ######### # # # # # # # ##### # ####### ### # ### # ##### # ### # ####### ### ### # ### ####### #
#. .#.#.#. . . . .#. . . .#. . .#.#. .#. . .#.#. . . . .#. .#.#.#.#. .#. . .#. . . .#. . .#. .#. . .#. . .#.#. . . .#. .#. .#.#.#. .#. . .#.#
### # # # # ##### # ### ### ### # ### ##### # ##### # ### ### ### ########### # # # ##### ### ### # # # ### ### ##### # ### ### # ##### #####
#. .#. .#.#. .#. . . .#. .#.#. . . .#. .#. . . .#. .#. .#. .#.#. . . .#.#. . .#.#.#. . .#. .#. . .#. .#.#. .#. .#. . .#.#. .#.#.#.#.#. .#.#.#
### # ##### # # # # ####### # # ### # ######### ### ### ### ### ####### ##### ##### ##### ### ##### ### # ####### # # ### # # # ### ### # # #
#. . . . . .#.#.#.#.#.#. .#.#.#.#.#. .#.#. . .#.#. .#. .#. . .#. . .#. .#. . .#. . .#. .#. .#.#. . .#. .#. . .#. .#.#.#. .#. .#. . . .#.#. .#
##### ### ### # # ### # ##### ### ### # # ### # # ### ####### ##### ### ##### ##### # # ################### ### # # ### # ### ######### # ###
#. .#.#. . .#.#.#.#. . . .#. .#. .#.#.#. . .#.#. .#. . .#. .#. .#. .#. . . . . .#. . .#.#. . .#. .#. .#.#. .#.#.#.#. .#.#.#. .#.#.#. . . .#.#
# ### # ######### ### # ##### # ### # # ########### # # # # # ### ### # # ##### ### ####### ### # # ### ### # ##### ##### # ### # ####### # #
#. . .#. .#.#. . . .#.#. .#. . .#. .#. . . .#.#. . .#.#. .#.#.#. .#.#.#.#. .#.#. .#.#. .#. .#. .#.#. .#. .#. . . .#.#. .#.#. .#.#.#. . .#.#.#
### # ##### ##### ### # ####### ### ### # ### ####### # ########### # ##### # # # # # ##### ### ##### # ### # ### # # ### ##### # # ##### # #
#. .#.#. .#. . . . .#.#.#.#. .#. . .#.#.#. . . . .#.#.#.#. . .#.#.#.#. .#.#.#.#.#.#. .#. .#. . .#. . . .#.#.#.#.#.#.#. .#. . . . . . . . . .#
# ##### ##### ##### # ### # # ####### ### # # ### # ####### ### # # ##### # # # ##### # ####### ####### # # ### # # ### # # # # # # # ##### #
#. . .#.#. .#. .#.#. . . . .#.#.#. . . . .#.#.#.#.#. . . . . .#. .#. .#. .#.#. .#. . . .#.#.#. . . .#.#.#. . . .#.#.#. . .#.#.#.#.#.#.#.#.#.#
### ### # ### # # ### ### # ### # ### # ### # # ### ############# # # # ### ### ####### # # # ### ### # ### ######### ### # ### ### ### # ###
#. .#. .#.#. .#. .#. . .#.#. .#.#. .#.#. .#.#.#. . .#. . .#.#.#.#. .#. . .#. .#.#.#. . .#. .#.#.#. . . . . . .#. .#. .#. .#. .#.#. .#.#. . .#
# # # # # ######### ### # ##### # ##### ### # # ### ### # # # # ####### # ### ### ### # # ### # ####### # ####### ####### ##### ##### # ### #
#.#.#.#. . . .#. .#.#. .#. . . . .#. . .#. .#. .#. . . .#. . .#. . . .#.#.#.#. .#.#. .#. .#.#.#. . . . .#. . . . .#. . .#.#. . . .#. .#. .#.#
##### # # # ##### ############# ############# ##### ##### ### # ####### # # ##### ######### ####### ##### ####### ### ######### # # # ### ###
#. .#.#.#.#.#. .#.#.#. . . . . .#.#.#. .#.#. .#. .#. . .#.#. .#.#. .#. .#.#. .#. .#. . . . .#. .#. . .#. . . . .#. . .#. .#. . .#. .#. . . .#
# ######### ### # # # ####### ### # # ### # # # # # ##### ### # # ##### ##### # ### ####### ### # ####### ########### ### ######### ### # # #
#.#.#. . . . .#.#.#.#.#. . . .#. . .#. .#. .#. .#.#. . .#.#. . . . .#.#. .#.#. . .#. . .#. . .#. . . .#. . .#.#. .#. . .#.#.#.#.#. .#. .#.#.#
# # # ### # # # # # ##### ### ### ### ### ################# ### # # # # ### # ##### ##### ### ### # ### ### # # # ### # # # # # ##### ##### #
#. .#. .#.#.#. .#.#. .#.#.#.#.#. . . .#.#. .#.#.#. .#.#. .#. .#.#.#.#. . . . . .#. .#. .#.#. .#.#.#.#. . .#.#. .#.#. .#.#. . . .#. . .#.#.#.#
# ### ######### # # ### ### ### # ### # ##### # ### # ### # # # ### ##### ### ##### # # # # # # ########### ### ##### ####### # ### # # # # #
#.#.#. .#.#.#. . . .#. .#.#.#. .#.#. . .#. . . . .#. . .#. .#.#. .#. . . . .#.#. . .#.#.#.#.#.#.#.#.#. . . . . .#. . .#. .#. .#.#.#.#. . .#.#
# # ##### # ### ### # ### # ### # ##### ### ### # ### # ##### # # ##### # ######### # ### ### # # # # # # # ### ### ### # # ### # # # ##### #
#.#. .#. . . . .#. . . . .#. . .#. .#. .#.#.#. .#.#.#.#.#. .#.#.#.#.#.#.#. . .#. . .#.#. .#. .#. . . .#.#.#.#. . .#.#.#.#. .#.#. . .#. .#.#.#
# # # ### # # ### ####### # ##### ### ### ### ##### ### ### # ##### # ### ####### # # ### ### ### ### ### ### # ### # ##### # # # ##### # ###
#. .#. . .#.#.#. . . .#.#.#. .#.#.#.#.#. .#. .#. . .#.#.#.#. .#.#.#.#.#.#. .#. .#.#. .#.#. .#. . .#. . .#. .#.#.#. .#. .#.#.#. .#.#. . . . .#
# ### ### # ##### ### # ### ### ### ### ##### ### # # # # ### # # # # # # ##### # ##### # ####### ##### ##### ######### # ##### ####### #####
#.#. .#. .#.#.#. .#.#. . . .#.#.#. . . .#.#. .#. .#.#. . . .#. . . . . .#. .#. . .#.#. . . . .#. . .#.#. .#. .#.#.#.#. . . .#. .#. . . . . .#
### # ##### # # ### ### # ### # ### ##### # ### ##### ### ### ##### ### # ##### ### # ### ####### ### # ### ### # # ### ####### ##### ##### #
#. .#.#. .#. .#. . .#.#.#.#. . .#. . .#. . .#.#.#. .#.#. . . .#. . . .#.#. . .#.#. .#.#. . . .#. .#. . .#. .#. .#. .#. .#. .#. . .#.#. .#.#.#
### ### ### ##### ### ### # # # # ### # # ### # # ##### ########### ##### # # # # ########################### # # ##### # # ### # # ##### # #
#. .#. .#. .#. . .#. . . . .#.#.#.#. . .#.#.#. .#. . .#.#. .#. . . . . .#.#.#.#.#. . .#. .#. . .#.#. . . .#. .#. .#.#. . .#.#. .#.#. .#. . .#
# ### ### ################# # ##### # ### # # # # ####### ##### # ### ### ### # ### ### ##### ### ##### ##### ##### ##### ### ### # ##### ###
#.#. . .#. .#. . . . . . .#.#. .#. .#.#.#.#. .#. .#.#. . . .#. .#.#. .#.#.#. .#.#. . .#. . .#.#.#.#.#.#. .#. .#. . .#.#. . . . .#.#. . . . .#
# ##### ### ##### # ### ### ### ### ### # # ####### ##### ##### ### # # # # # # ### ### ##### # # # # # # ### # ### # ### ####### ##### #####
#.#. .#.#.#.#. . .#.#.#.#. . .#.#. . .#. . . .#.#. .#.#.#. . . .#. .#. .#.#.#.#.#. . . . . . . . .#.#. .#. .#.#.#.#. . .#. .#. .#.#.#. .#. .#
# # # # # ### # # ### # ### # # # ### # ### # # # # # # ### # # ### # ### ### # # ####### # # ### # ##### ### ### # ##### # ### # # ####### #
#.#.#. . . . .#.#. .#. . . .#.#. . .#.#.#. .#. .#.#. . . . .#.#. .#.#.#.#.#.#. . . . . .#.#.#.#. . .#. .#. . .#.#. . . .#.#. .#. .#. . . . .#
# ### ##### ##### ####################### # ########### # # ####### ### ### ### ### # ######### ####### ### ### # ####### ######### ### # ###
#.#.#. .#. . . .#.#.#. .#.#. .#. . .#. . .#. .#.#. . . .#.#.#.#. .#.#. .#. . .#. .#.#.#. . . . .#.#. . .#. .#. .#. .#.#. . . .#. .#.#. .#. .#
# # ####### ####### ### # # ### ########### # # ### # # ##### ### ##### # ### # # # ##### # ##### # ### # ##### ### # ##### ### ##### ### ###
#.#. . . . .#.#. .#. . .#. . . . . .#. . .#.#. . .#.#.#. .#.#. .#.#. .#. .#. .#.#.#. .#.#.#.#.#. .#. .#. . .#. . . .#. .#.#. . . . .#.#. . .#
####### ### # # # ### # # # ##### ####### ### # ### ##### # ### # # ##### # # ##### # # # # # ### # ##### # ### # # # ### # ### ### # ### # #
#. . . .#.#.#. .#.#.#.#.#.#. .#.#.#. .#. . . .#. . . . .#. . .#. . . . .#.#.#.#. . .#. .#.#. .#. . .#. .#.#. .#.#.#.#. . . .#.#.#. .#. .#.#.#
# # ### # # ##### # ### ### ### # # ### ##### # ### ### # ####### # ##### ### # ### # ### ### # ### # ##### ### ### ### # ### # ####### #####
#.#.#. . .#.#. . .#. . .#. .#.#. . .#. . .#.#.#. .#. .#.#. .#. . .#.#. . .#. . .#. .#.#. . .#.#.#.#. . .#.#.#. .#.#.#.#.#.#. . .#. .#. . . .#
######### ##### # # ##### ### # # ### ##### ### ##### ####### # # # ### # ####### # ####### # ### # ### # ####### # # # ######### ####### # #
#.#. .#. . . .#.#.#. .#.#. . .#.#. . . .#.#. .#. .#. .#.#.#. .#.#.#.#.#.#.#. .#.#.#.#. .#. .#.#.#. .#. . . .#.#.#. . .#. . . . . .#. . . .#.#
# ### ### ### ### # ### # # # ##### ##### ### ### ##### # # ### # ### ### # ### # ### ####### # ### # ### # # # # ##### # # ########### # # #
#.#. . .#.#. . . . . .#. .#.#. . .#.#. .#. .#. . . .#. . . .#. .#.#.#.#. .#. .#. .#.#.#.#. . . .#. .#.#. .#. . .#. . . .#.#.#. . . . .#.#.#.#
# ### # # # # ### # ####### # ####### ##### # # ### ######### # # # # ####### ### # # # ### # # ### ### # # ##### # ### ### # ### ######### #
#. . .#.#.#.#.#. .#.#.#. . .#.#. .#.#.#.#. .#.#.#. . . .#.#.#.#.#.#. . .#. . .#. .#. .#.#.#.#.#.#. . .#.#.#.#. .#.#.#.#. .#. .#.#.#. .#.#. .#
# # # ####### ### ### # ### ### ### # # ### # ### ### # # # ### # # ### ##### # # # # # # # # # # ######### # ### ### # # ##### # # # # # # #
#.#.#. .#.#. . .#.#. .#.#. .#. .#. .#. .#.#.#.#. . .#.#. .#. . .#.#. .#.#.#. .#.#. .#.#.#.#.#.#.#. . . . .#. .#.#. .#. .#.#. . . . .#. . .#.#
# ##### # # # ####### # # ### # ### # ### # ##### ##### ####### # ##### # # ####### ### # ############# ##### # # ########### # ####### #####
#.#.#. .#.#.#.#. .#.#. .#.#. .#. . . . . . .#.#.#.#.#.#.#. .#.#.#.#. . . . .#. .#. . . . .#. .#. . .#. .#. . . . . . .#. . .#.#.#. .#. . .#.#
### ### # ### # ### ### # # ######### ### ### # ### # # # # # # ### ### ### # # ### ### ### ##### ############# ### ##### ### ##### # # ### #
#. . . . . . . . . . .#.#. .#. . . . .#.#.#.#. .#.#.#. .#.#.#.#. .#. .#.#. . .#.#. .#. . . .#.#.#. . .#.#. .#. .#.#. . . . .#. . .#. .#. .#.#
# # ### ### ### ######### ####### ### # ### ### # # # ### ### ### ##### ### ####### ### # # # # # # ### # # # # # # ### ######### # # ### # #
#.#.#. .#. .#. . . . .#. . . . .#.#. . .#. . . . . . . . . . . . .#. . . .#. . . . .#. .#.#. . .#.#. . . .#. .#. .#.#. . . .#. . .#.#. .#. .o
#############################################################################################################################################