
#o###############################################################################
#.#. . .#. .#. . . . . .#. . . . .#. . . . . . . . . .#. . . . .#. . . . . .#. .#
# ### # # # # ### ####### ##### # ##### ############# # ####### # ####### # # # #
#. . .#.#.#. .#. .#. .#. . . .#.#. . .#. . .#. . . .#.#. .#. .#. .#. . .#.#. .#.#
####### # ##### ### # # ####### ##### ##### ### ### # ### # # ##### ### # #######
#. . .#.#. . .#. .#.#. .#. . .#.#. .#.#. . . . .#. .#.#. .#.#. .#. .#. .#. . . .#
# # ### ######### # ##### ### # # # # ############### # ### ### # ### ######### #
#.#. .#. . .#. . .#.#.#. .#. . .#.#.#.#. . .#. . . .#. . .#.#.#. .#. .#. . .#. .#
##### ##### # ##### # # ######### # # # ### # ##### # ##### # ##### ### ### # # #
#. .#. . .#.#. . .#.#.#.#. . . . .#.#. .#.#. .#. .#.#. .#. .#. . .#. . .#.#.#.#.#
# # # # ### # ### # # # # ######### ##### ####### # # ### ### ########### # # # #
#.#.#.#.#. .#. .#.#. .#. .#. .#. . .#. . . . . . .#.#.#. .#.#. . . . .#. . .#.#.#
# # ### # ####### # ####### # # ########### # ##### # # ### # ### ##### ##### ###
#.#. . .#.#. . .#. .#. . . .#. .#. . . . . .#.#. . .#.#.#. .#. .#. . .#.#. .#. .#
# # ##### # ### # ### ########### ########### # ####### # # ### ##### # # ### # #
#.#.#. .#. .#. .#. .#.#. . . .#. . . .#. .#. .#.#. . . .#.#. . . . .#. .#. . .#.#
# # # # ##### ##### # # ##### # ##### # # ##### ### ############### ######### # #
#.#.#.#. . . .#.#. .#. .#. .#.#.#. .#.#.#. .#. .#. .#. .#. . . . .#. . . . .#.#.#
# # # ######### # ####### # # # # ### # ### # ### ### # # ####### ######### ### #
#.#.#.#. .#. . . .#. . .#.#.#.#. .#. .#.#.#. .#. .#. .#. .#. .#. .#. . . .#. . .#
# ### ### # ##### # ### ### # ### # ### # ##### ### ####### # # ##### # ####### #
#. .#. .#. .#. .#.#.#.#.#. .#.#. .#. .#.#. . . . .#. .#. . .#. .#. . .#.#. . .#.#
# # ### ##### # # # # # # # # # ##### # # ####### ### # # ####### ####### ### # #
#.#. .#. . .#.#.#. .#. .#.#.#.#. .#.#. .#. . .#.#. . .#.#.#. .#. .#. . .#.#.#. .#
# # ####### # # ##### ### ### ### # ######### # ####### ### # ### # ### # # #####
#.#.#. . .#. .#. . .#.#. .#. .#.#.#. . . . .#. .#. . .#. . .#. .#. .#.#. .#. . .#
# # # # # ######### # # ### ### # ##### # # ### # ### ######### # ### ##### ### #
#.#. .#.#. . . . .#.#. .#. .#. .#. . .#.#.#. .#. .#. .#. . .#. .#.#.#. .#. .#.#.#
# ##### ######### # ##### ### # ##### ### ######### ####### # ### # # # # ### # #
#.#. . .#. .#. . .#. .#. .#. .#. . .#. .#. . .#. . . . . . .#. .#.#. .#.#. . .#.#
# # ### # # # ####### # ######### # ### ##### # ############### # # ### ##### # #
#.#. .#.#.#.#. . . .#.#. .#. . .#.#. .#. . .#. . .#. . . . . . .#.#. .#. . . .#.#
# ### ### # ######### # # # ### ### ####### ####### ############# ############# #
#.#.#.#. .#. . . .#. .#.#. . .#. .#. . . .#.#. . .#. .#.#. . . .#. . . .#. . .#.#
# # # # ######### # ######### ### ####### # # ### ### # # ##### ####### # ### # #
#.#.#. .#. . . .#. .#. . . .#. .#.#. . .#. . .#.#. .#.#. .#. .#. .#. .#. .#. .#.#
# # ##### ############# ### ##### # ### ####### ### # ##### # # # # # ##### ### #
#. . .#.#. . . .#. . .#. .#. . .#. .#. .#. .#. . .#.#. .#. .#. .#.#.#. . .#.#. .#
##### # # ##### # # # # # ##### # ### ### # ### ### # # # ####### ##### # # # # #
#.#. .#. .#. .#. .#.#.#.#.#. .#.#.#. .#. .#. .#.#. .#.#.#. .#. . . .#. .#.#.#.#.#
# # ### ### # ##### # # # # # # ### ### ##### # # ### # ### ####### # ### # # # #
#.#.#.#.#. .#.#. . .#.#.#.#.#. . . .#. .#.#. .#. .#. .#.#. .#. .#. . .#.#.#.#.#.#
# # # # ##### # ##### # # # ######### ### # ### ####### # ### # ####### # # # ###
#.#.#. .#. . .#.#. .#.#.#.#. .#. . . .#. .#.#. .#. . . .#. . .#. . .#. . .#.#. .#
# # # ### ### # ### # ### ### # ####### ### # ### ### ########### # ### ### ### #
#.#.#.#. .#.#.#. .#.#. .#. .#.#. . .#. . .#.#.#. . .#.#. . .#. .#.#. .#.#.#.#. .#
# # # ### # # ### # ### ### ####### ##### # # # ### # # ### # # ### # # # # # # #
#. .#. .#.#.#.#.#.#. .#. .#. .#. . . . . .#.#.#. .#.#.#. .#. .#. .#.#.#. .#. .#.#
# ##### # # # # # # # ### ### # ########### # ##### # ### ####### ### ### ##### #
#.#. .#. .#. . .#.#.#. .#. .#. .#. .#. .#. .#. . .#.#.#.#. .#. .#.#. .#. . .#. .#
# # # # ######### # ####### # ##### # # # ####### # # # ### # ### # ####### # ###
#.#.#. .#. . . . .#. . . . .#. . . .#.#. .#. . .#. .#. . .#.#. .#.#. . . .#.#.#.#
# # ##### ######### ############### # ##### # # # ######### ### # ####### ### # #
#.#.#. .#. . . . .#.#. . . . . .#. .#.#. . .#.#.#.#. . . . . . .#.#. . .#. .#. .#
# ### # ### ##### # # ##### ### ##### ### ### ### # ############# # ### # # ### #
#. . .#. .#.#. . .#.#.#. . .#.#. . .#. .#. .#. . .#.#. .#. .#. .#.#.#. .#.#. .#.#
######### # # ##### ### ##### ##### ### # ####### # ### # # # # # # # ### # # # #
#. . . .#.#.#. .#. . . .#. .#. . .#. .#.#.#. . .#.#. .#.#.#. .#. .#.#. .#.#.#.#.#
####### # # ### ######### # # ### ### # ### ### ##### # # ######### ### ### # # #
#. . . .#.#. .#. .#. .#. .#. .#. . .#.#.#. . .#. . .#. .#.#. .#. . .#.#. . .#.#.#
# ####### ### ### # ### # ######### # # # ####### # # ### # # # ### # ##### ### #
#. . . .#. .#. .#.#.#. .#.#. . . .#.#.#.#. .#. .#.#. .#. .#.#. . .#.#. .#. .#. .#
# ##### ### ### # # # ### # ##### ### # # ### # ####### ########### # ### ### ###
#. . .#. .#. .#.#.#.#.#.#.#.#. .#.#. .#. .#. .#. .#. . .#. . . .#. .#. .#.#.#.#.#
### ##### ### ### # # # # # # # # # ##### # ##### # ##### ##### # ##### # # # # #
#. .#. . . .#. . .#.#.#.#. .#.#. .#. . .#.#.#. .#. .#. . .#. .#. .#. . .#. .#.#.#
# ### ### ######### # # ##### ### ##### # # # # ######### # ### ##### ##### # # #
#. .#. .#.#. . . .#.#. .#. .#. .#. .#. .#.#. .#. .#. . . .#. . .#. .#. . .#.#.#.#
### ### # # # ### # ### # ##### ##### ######### # # # ####### ### # # # ### # # #
#. .#.#.#.#.#.#.#. . .#.#. . .#. .#. .#. . . .#.#.#.#. . . .#. .#.#.#.#. . .#.#.#
# ### # ### # # ##### # ### # ### # ### ##### ### # ####### ##### # ##### ### # #
#. . .#.#. .#.#. . .#.#.#. .#.#.#. .#. . .#. . . .#. . . .#. . . .#. . .#. .#. .#
### ### # ### # # ### # # ### # ######### ##### ######### ############# ### ### #
#.#.#. .#.#.#.#.#. .#.#. .#.#.#. . . . .#. .#. .#. . .#. .#. . .#. . .#. .#.#.#.#
# # # # # # # ##### # ##### # ####### # ### ##### ### # ### ### ### ##### # # # #
#.#.#.#.#. .#. . .#. . .#.#. .#. . . .#. .#.#. . .#.#.#.#. .#.#. .#. . .#.#. .#.#
# # # ##### ##### ##### # # ### ######### # # ##### # # # ### ### ### ### ##### #
#.#.#. . .#.#. .#. .#. . .#.#. .#. . .#. .#. . . . .#.#. .#.#. .#. .#. .#. . .#.#
# # ### ### ### ### ####### # ### ### # ############# ##### # # ### ### ##### # #
#. . .#. . . . . .#. . . . . .#. . .#. . . . . . . . .#. . . .#. . . . . . .#. .o
#################################################################################